​/api​/Account​/Coupons	frequency==3
​/api​/CraftedIngridient​/{id}	frequency==3
​/api​/Ingredients​/{id}	frequency==3
​/api​/Restaurants	frequency==3
​/api​/Restaurants​/{id}	frequency==3
​/api​/SubCategories​/{id}	frequency==3
​/api​/CraftedIngridient	frequency==2
​/api​/Discounts	frequency==2
​/api​/Dishes	frequency==2
​/api​/Dishes​/{id}	frequency==2
​/api​/Employees	frequency==2
​/api​/Ingredients	frequency==2
​/api​/v2​/Orders	frequency==2
​/api​/v2​/Orders​/{id}	frequency==2
​/api​/Account​/register	frequency==1
​/api​/Account​/CreateCustomerAccount	frequency==1
​/api​/Account​/CreatePaymentIntent	frequency==1
​/api​/Account​/CreatePaymentMethod​/{paymentIntent}​/{tokenCard}	frequency==1
​/api​/Account​/PaymentMethods	frequency==1
​/api​/Account​/PaymentMethods​/{id}	frequency==1
​/api​/Account​/ListCoupons	frequency==1
​/api​/Account​/AddCoupons	frequency==1
​/api​/Account​/DefaultPaymentMethod​/{id}	frequency==1
​/api​/Account​/getuserbytoken	frequency==1
​/api​/Account​/{userId}	frequency==1
​/api​/Account​/updateuser	frequency==1